12:12
0 0 0 0 0 0 0 0 0 0 51 0
0 0 18 18 18 18 18 18 18 18 0 0
0 0 0 0 0 0 0 0 0 18 0 0
0 0 0 0 0 0 0 0 0 18 0 0
0 0 0 0 0 0 0 0 0 18 0 0
0 0 18 18 18 18 18 18 18 18 0 0
0 0 18 0 0 0 0 0 0 0 0 0
0 0 18 0 0 0 0 0 0 0 0 0
0 0 18 0 0 0 0 0 0 96 0 0
0 0 18 18 18 18 18 18 18 18 0 0
20 0 96 0 0 0 0 0 0 0 0 0
