16:16
0 0 0 0 0 0 0 0 0 48 53 0 0 0 0 0 
0 0 0 0 36 0 96 0 0 0 0 0 0 0 0 0
17 18 17 18 17 18 17 18 17 18 18 17 0 0 18 17
0 0 0 0 0 0 0 0 0 36 0 0 96 0 0 0
0 0 0 0 0 0 0 0 96 0 0 0 38 0 0 0
0 0 0 0 0 0 0 35 0 36 0 0 0 0 0 0
17 18 17 35 17 18 0 0 0 0 18 17 18 17 18 17
0 0 0 0 0 96 0 0 0 0 0 0 0 0 0 0
0 0 35 0 0 38 0 0 0 0 0 0 0 0 0 0
0 0 0 0 0 0 0 96 0 35 0 0 0 0 0 0
0 0 0 0 0 96 0 0 0 0 0 0 0 0 0 0
17 18 17 0 0 18 17 18 17 18 18 17 18 17 18 17
0 0 0 0 0 96 0 36 0 0 38 0 0 0 0 0
0 0 0 0 0 0 0 0 0 0 0 35 0 0 0 0
17 18 17 18 17 18 17 18 17 18 18 17 0 0 18 17
64 0 0 0 0 0 0 96 0 0 38 0 0 0 0 0
