12:12
0 0 0 0 0 0 0 0 0 50 0 0
17 17 0 0 17 96 17 0 0 0 17 17
0 0 0 0 0 0 0 0 0 0 0 38
17 0 0 0 33 0 0 0 64 0 0 0
0 38 34 34 34 34 0 0 0 0 0 0
0 0 0 0 96 0 0 0 18 0 0 0
34 0 37 0 0 0 0 0 0 0 0 0
0 0 0 0 0 0 36 0 0 0 18 0
34 96 0 0 0 17 0 0 0 38 0 0
34 0 0 18 0 0 18 0 0 0 0 17
64 17 48 37 17 17 17 17 17 17 17 96
38 0 0 0 0 0 34 0 0 0 0 17
