12:5
0 0 0 0 0 0 0 0 0 49 53 0
0 0 0 0 0 18 18 0 0 0 0 0
0 0 0 0 18 18 18 0 0 0 0 0
0 0 0 18 0 18 18 0 0 0 0 0
0 0 18 0 0 18 18 0 0 0 0 0
0 0 0 0 0 18 18 0 0 0 0 0
0 0 0 0 0 18 18 0 0 0 0 0
0 0 0 0 0 18 18 0 0 0 0 0
0 0 0 0 0 18 18 0 0 0 0 0
0 0 0 0 0 18 18 0 0 0 0 0
0 0 18 18 18 18 18 18 18 18 0 0
0 0 0 0 0 0 0 0 0 0 0 0
