18:18
0 0 35 0 0 0 0 0 0 51 0 0 0 0 0 0 0 0
0 0 0 0 0 0 0 0 0 0 0 0 0 0 96 38 0 0
17 18 17 18 17 18 17 18 17 18 18 17 0 0 18 17 18 17
0 0 0 96 0 0 0 0 0 0 0 36 0 0 35 0 0 0
17 18 17 18 17 0 0 18 17 18 17 18 18 17 18 17 18 17 
38 0 0 0 0 0 0 0 0 0 0 0 0 0 96 0 0 0
17 35 17 18 17 18 17 18 17 18 18 17 0 0 18 17 18 38
0 0 35 0 0 0 0 0 0 0 0 0 0 0 0 0 0 0
17 18 17 18 17 0 0 18 17 18 17 18 18 17 18 17 18 17 
0 0 0 0 0 0 0 0 0 0 0 0 0 0 96 0 0 0
17 18 17 18 17 18 17 18 17 18 18 17 0 0 18 17 18 17
0 0 0 0 0 0 0 96 0 0 0 0 36 0 0 0 0 0
17 18 17 18 17 0 0 18 17 18 17 18 18 17 18 17 18 17 
0 38 0 0 0 0 0 0 38 0 0 0 0 96 0 0 0 0
17 18 17 35 17 18 17 18 17 18 18 17 0 0 18 17 18 17
0 0 0 36 37 0 0 0 0 0 0 96 0 0 0 0 0 0
17 18 17 18 17 0 96 18 17 18 17 18 18 17 18 17 18 17 
20 0 0 0 0 0 0 0 0 0 0 0 0 0 0 0 96 0